0,0
8,8
3
7,4
7,0
8,8
0,4,3,5
0,4,4,3,7,4,7,4
14,0
8,8
0,2,4,2,5,3
0,4,3,3,4,3,5,3,5,4,7,4
21,0
8,8
0,4,4,2,3,5
0,4,4,2,3,3,4,3,7,3,5,4
28,0
8,8
0,4,2,4,2,5,2,4,3
0,3,3,3,3,4,4,4,2,5,4,5,5,5,2,6,6,7
28,7
8,8
0,4,2,2,2,4,2,2,4,4,2,2,2,2,5,2,4,3
6,0,1,1,4,1,5,1,5,2,1,3,2,3,3,3,4,3,3,4,4,4,5,4,6,4,1,5,5,5,3,6,6,6,1,7
s
